!!!#!!###!!#@
!#!!!#!!!!##-
####!#!#!#!##
!!!#!!!#!#!!!
!#!####!!!##!
!#!!!!!!#!!!!
!############
!!!!!!!!!!!!!



---#--###----
-#---#----##-
####-#-#-#-##
---#---#-#---
-#-####---##-
-#------#----
-############
------------@