!!!#!!###!!#@
!#!!!#!!!!##-
####!#!#!#!##
!!!#!!!#!#!!!
!#!####!!!##!
!#!!!!!!#!!!!
!############
!!!!!!!!!!!!!